111111
1P0C11
100011
1C0EC1
111111
