1111111
1000001
1PC00E1
1111111
