11111111111111111111
1P000100010001000011
10001111111111000001
10000000000000000001
10101010101010101001
10001000100010001001
10101010101010101001
10000000000000000001
10111111111111111001
10000000000000000001
10101010101010101001
10001000100010001001
10101010101010101001
10000000000000000001
10111110111110111101
10000000000000000001
10101010101010101001
10001000100010001001
1000000C000000E00001
11111111111111111111
