111111
1P0C11
100011
100011
100011
100011
100011
100011
100011
1C0E11
111111
