11111111
1P00C111
10010E11
11111111

