11111111111111111111111111111111111111
1P0000000000000000000000000000000000E1
1000000C0000C0000000000C0000C000000011
100000CCC00CCC00000000CCC00CCC00000011
1000000CCC0CCC00000000CCC0CCC000000011
10000000CCCCC0000000000CCCCC0000000001
100000000CCC000000000000CCC00000000001
1000000000C00000000000000C000000000001
11111111111111111111111111111111111111
