111111
100011
100011
100011
100011
1E0PC1
100011
100011
100011
100011
111111
