1111111111111
1P000000000E1
1000111111001
1C001000100C1
1000111111001
1000000000001
1111111111111
