11111111111111111111111111111111111
1P0000000000000000000000000000000E1
100000000C0000000000000000000000011
10000000CCC000000000000000000000011
1000000CCCCC00000000000000000000011
100000CCCCCCC0000000000000000000011
10000CCCCCCCCC000000000000000000011
10000000000000000000000000000000001
11111111111111111111111111111111111
