1111111111111
1P000000000E1
1111011111011
1C00000010001
1011110111111
10000000000C1
1111111111111
